SSSSSSSSSSSSSSSSSSSSSSSSSSSSSSSSSSSSSSSS
SIIIIIIOIIDIBOIIIIIBIBIIIIIIIOIIIIBIIIIS
SIBRBIIIIIIOIIIIIIIIIBDIIBIIIIOIIIIIOIIS
SIIIIIIIIIIOIIBIIIIIBIBIIBIIIIIIIIBIIIIS
SBIOBIIIIIIIIIOIIIIIIBIIBIIIIBIIIBIIIIIS
SBIBOIIIIIIIIIBBIIBIIIIIIIIBIIIIIIBIBBIS
SIIIBIIBIIIIIIIIBIIIIIBIOBIIIIIIIIBIBBIS
SWWWWWWWWWWWWWWWWWWWWWWWWWWWWWWIIIBIIOIS
SIOIIIBIIDIOIIBIBIIIIIIIIIIDIBDIIIIIIBIS
SIIDIIIIIBIIIIIOIIIIIIIIBOOBIIBIIIIBIIIS
SIIIBIIBIBIIIIIIIIIIIIIIBBIBIIOIIIIIIIIS
SIBIIIIIBIIIIIIIIBBBIIIIIIIBIIBIDIIIIOIS
SIOIIOIIBIOOIIIIIBIODIIDIIIIBIIIBIIDIBIS
SIDBIIIIIIIIIIIIIIBBBIIBIIIIIIIIDIIIIIBS
SIIIIIIIIWWWWWWWWWWWWWWWWWWWWWWWWWWWWWWS
SOOIIIIIIIIIOIIIDIIIIBIIIIIBIIIBIIIIIIIS
SBOIIIIIIIIIBBIIBIIIIIIIIBIIIIIIBIBBIIES
SIBIIBIIIIIIIIBIIIIIBIOOIIIIDIIIBIBBIIIS
SIIIIBDIIOIIIIIIIIBIIIIIIBIBDIIIIIIOIIIS
SIIIOIIOIBIIBIBBIIIIIIIIIBIBDIIIIIIBIIBS
SIDIIIIBIIIIIOIIIIIIIIIOIBIIBIIIIBIIIBIS
SSSSSSSSSSSSSSSSSSSSSSSSSSSSSSSSSSSSSSSS
12 10