SSSSSSSSSSSSSSSSSSSSSSSSSSSSSSSSSSSSSSSS
SBIWWIWBBIWIIIBWBIIBIIIIWIIIBIIIIIBWIDIS
SIIRWIDIBIWIIIWWWIIWIBIIIIBIIBIBIIIWIWBS
SIIIIWIIBDIIBIIIIWIIIIIBIWWBIIIIIIIWIWWS
SDIWIIWBWBIIBIIIIWIIIBIIIIIIBIBBIIIIIIWS
SBIWIIIWIIBIWWIIBIBBDIIIIIIIBIBBIIIIIIWS
SBBIIBIIIIWIIIBIIIIIIBIBBIIIIIIBIIDWWIIS
SIIBIWWIIBIBBIIIWIIIIBIBBIIIIIIWIIBIWIBS
SIIWIIIDIIIIIIDIBIIWWBIIBIWIWBIIWBIIDIBS
SBIBIIIIWIWWIIDIBIIWWBIIBIIDIWIIIWIIBIWS
SIBIWWIIIIIBBWBIIDIWIWBIIWBIIIWBIIDIBIIS
SWIWWIIIIIIBBWBIIBIWIWWIIIWIIBIWWIIBIWWS
SIWIBIBIWIIIWWBIIBIIIIWIIIBIIIIIWWIBIWWS
SIWIBIBIWIDIWIWBIIWBIIIIBIIBIBBIIIIWIIIS
SWIIWBWBIIBIIIIWIIIDIIIWIBWIIIIIIWIWWIDS
SWIIIWWBIIWIDIIIWBIIBIBIIIBIWBIIIIIIWIIS
SWIDIIIIBIWWIIBIWWBIIIIIIIBIWBIIIIIIWIIS
SIIBIIIIWIIIBIIIIIIBIBBIIIIIIWIIBIWIIIWS
SBIWWIIBIWWIIIWIIIIBIBBIIIIIIWIIBDIIBIIE
SWIIIBIIIIIIBIBDIIIIIIBIIIWWIIWBIIDIWIIS
SBBIIIWIIIIIBIBDIIIIIIWIIBIWDIDIBWIBIIIS
SSSSSSSSSSSSSSSSSSSSSSSSSSSSSSSSSSSSSSSS
24 15 250 150