SSSSSSSSSSSSSSSSSSSSSSSSSSSSSSSSSSSSSSSS
SRIIIIIIIIIIIIIIIIIIIIIIIIIIIIIIIIIIIIIS
SIIIIIIIIIIIIIIIIIIIIIIIIIIIIIIIIIIIIIIS
SIIIIIIIIIIIIIIIIIIIIIIIIIIIIIIIIIIIIIIS
SIIIIIIIIIIIIIIIIIIIIIIIIIIIIIIIIIIIIIIS
SIIIIIIIIIIIIIIIIIIIIIIIIIIIIIIIIIIIIIIS
SIIIIIIIIIIIIIIIIIIIIIIIIIIIIIIIIIIIIIIS
SIIIIIIIIIIIIIIIIIIIIIIIIIIIIIIIIIIIIIIS
SIIIIIIIOOFIIIIIOOFIIIIIOOFIIIIIOOFIIIIS
SIIIIIIIOOOIIIIIOOOIIIIIOOOIIIIIOOOIIIIS
SIIIIIIIODOIIIIIODOIIIIIODOIIIIIODOIIIIS
SIIIIIIIIIIIIIIIIIIIIIIIIIIIIIIIIIIIIIIS
SIIIIIIIIIIIIIIIIIIIIIIIIIIIIIIIIIIIIIIS
SIIIIIIIIIIIIIIIIIIIIIIIIIIIIIIIIIIIIIIS
SIIIIIIIOOFIIIIIOOFIIIIIOOFIIIIIOOFIIIIS
SIIIIIIIOOOIIIIIOOOIIIIIOOOIIIIIOOOIIIIS
SIIIIIIIODOIIIIIODOIIIIIODOIIIIIODOIIIIS
SIIIIIIIIIIIIIIIIIIIIIIIIIIIIIIIIIIIIIIS
SIIIIIIIIIIIIIIIIIIIIIIIIIIIIIIIIIIIIIIS
SIIIIIIIIIIIIIIIIIIIIIIIIIIIIIIIIIIIIIIS
SIIIIIIIIIIIIIIIIIIIIIIIIIIIIIIIIIIIIIIE
SSSSSSSSSSSSSSSSSSSSSSSSSSSSSSSSSSSSSSSS
4 50 200 150