SSSSSSSSSSSSSSSSSSSSSSSSSSSSSSSSSSSSSSSS
SDDDBBDDBDDBIBBBBDBDDIDDBDDBDDDDBBDBDBBS
SDBBDDDBBBDBDDBBBBBBDBBDIDBDBBBBDBDDBBDS
SDDBBBBBBBDBDDBBIBBBDBBDDDBDBIBBDBBBDDBS
SBBDBDDBBBBBBDBBDDDIIDDBBDBDDBBDBDDIBBDS
SBBDBDDBBBBBBDBBDIDBDBBBBDBDBDBBDDBBDBDS
SDDDBBDBDIDDBBDDBBDDDBBDBDBBBIDBDDBBDBDS
SBBBBBDBBDDDDIIBBBDBDDIBDBDDBIBBDDDDDDBS
SDBDDWWWWWWWIWWWWWDBBBBDBWWWWWWIWWWWWWBS
SDIDDWOOOOOOOOOOOWBDDBBBDWOOOOOOOOOOOWBS
SDBDBWOREOOOOOOOOWBDDBBBDWOOOOOOOOOOOWBS
SDBBDWOOOOOOOOOOOWBIBBDDBWOOOOOOOOOOOWBS
SDBBDWOOOOOOOOOOOWDDDDBDBWOOOOOOOOOOOWDS
SBDDDWOOOOOOOOOOOWDBBDIDBWOOOOOOOOOOOWDS
SBBBBWOOOOOOOOOOOWDBBDDBBWOOOOOOOOOOOWBS
SDBDDWOOOOOOOOOOOWIBDBBDBWOOOOOOOOOOOWBS
SDBDDWOOOOOOOOOOOWWWWWWWWWOOOOOOOOOOOWBS
SBBBDWOOOOOOOOOOOOOOOOOOOOOOOOOOOOOOOWBS
SBBBDWOOOOOOOOOOOWDDIBDBDWOOOOOOOOOOOWBS
SDDBBWOOOOOOOOOOOWBBBDBDDWOOOOOOOOOOOWBS
SDDIIWWWWWWWWWWWWWDBBBDDDWWWWWWWWWWWWWDS
SSSSSSSSSSSSSSSSSSSSSSSSSSSSSSSSSSSSSSSS
75 5 300 150